DemoLevel 60*45
------------------------------------------------------------
----.-----------------------------------------------.-------
-----------------------.------------------------------------
-----------------------------------.------------------------
----------.------------------------------------------.------
------------------------------------------------------------
------------------------------------------------------------
------------------------------------------------------------
------------------------------------------------------------
------------------------------------------------------------
------------------------------------------------------------
------------------------------------------------------------
------------------------------------------------------------
------------------------------------------------------------
------------------------------------------------------------
------------------------------------------------------------
------------------------------------------------------------
------------------------------------------------------------
-----------------S------------------------------------------
------------------------------------------------------------
------------------------------------------------------------
------------------------------------------------------------
------------------------------##################------------
------------------------------#                #------------
------------M-----------------#        *       #-- ---------
------------#-----------------#                #------------
------------#-----------------####GGGGGGGGGG####------------
------------#-----------------------------------------------
------------#-----------------------------------------------
------------#-------#---------------------------------------
------------#-------#---------------------------------------
------------#-------############################------------
------------#-------#--------------------------#------------
------------#-------#--------------------------#------------
------------#-------############################------------
------------------------------------------------------------
----------------M----------M-------M-------M----------------
-------################################################-----
------------------------------------------------------------
------------------------------------------------------------
------------------------------------------------------------
------------------------------------------------------------
------------------------------------------------------------
------------------------------------------------------------
############################################################
OTHERSTUFF
