DemoLevel 60*45
------------------------------------------------------------
------------------------------------------------------------
------------------------------------------------------------
------------------------------------------------------------
------------------------------------------------------------
------------------------------------------------------------
------------------------------------------------------------
------------------------------------------------------------
------------------------------------------------------------
------------------------------------------------------------
------------------------------------------------------------
------------------------------------------------------------
------------------------------------------------------------
------------------------------------------------------------
------------------------------------------------------------
------------------------------------------------------------
------------------------------------------------------------
------------------------------------------------------------
------------------------------------------------------------
------------------------------------------------------------
------------------------------------------------------------
------------------------------------------------------------
------------------------------##################------------
------------------------------#                #------------
------------------------------#        *   *   #--*---------
------------#-----------------#                #------------
------------#-----------------####GGGGGGGGGG####------------
------------#-----------------------------------------------
------------#-----------------------------------------------
------------#-------#---------------------------------------
------------#-------#---------------------------------------
------------#---*---#---------------------------------------
------------#-------#---------------------------------------
------------#---*---#---------------------------------------
------------#-------############################------------
------------------------------------------------------------
------------------------------------------------------------
-------################################################-----
------------------------------------------------------------
------------------------------------------------------------
------------------------------------------------------------
------------------------------------------------------------
------------------------------------------------------------
------------------------------------------------------------
------------------------------------------------------------
OTHERSTUFF
