DemoLevel 60*45
------------------------------------------------------------
------------------------------------------------------------
------------------------------------------------------------
--------------------------------------------------------*---
------------------------------------------------------------
------------------------------------------------------------
------------------------------------------------------------
------------------------------------------------------------
------------------------------------------------------------
------------------------------------------------------------
------------------------------------------------------------
------------------------------------------------------------
------------------------------------------------------------
------------------------------------------------------------
------------------------------------------------------------
------------------------------------------------------------
------------------------------------------------------------
------------------------------------------------------------
-----------------S------------------------------------------
------------------------------------------------------------
------------------------------------------------------------
------------------------------------------------------------
------------------------------##################------------
------------V-----------------#                #------------
------------M-----------------#                #-- ---------
------------#-----------------#                #------------
------------#-----------------####GGGGGGGGGG####------------
------------#-----------------------------------------------
------------#-----------------------------------------------
------------#-------#---------------------------------------
------------#-------#--------------V------------------------
------------#-------############################------------
------------#-------#--------------------------#------------
------------#-------#--------------------------#------------
------------#-------############################------------
------------------------------------------------------------
----------------M----------M-------M-------M----------------
-------################################################-----
------------------------------------------------------------
------------------------------------------------------------
----------------------I-------------------------------------
------------------------------------------------------------
------------------------------------------------------------
------------------------------------------------------------
############################################################
OTHERSTUFF
