DemoLevel 60*45
------------------------------------------------------------
------------------------------------------------------------
------------------------------------------------------------
------------------------------------------------------------
------------------------------------------------------------
------------------------------------------------------------
------------------------------------------------------------
------------------------------------------------------------
------------------------------------------------------------
------------------------------------------------------------
------------------------------------------------------------
------------------------------------------------------------
------------------------------------------------------------
------------------------------------------------------------
------------------------------------------------------------
------------------------------------------------------------
------------------------------------------------------------
------------------------------------------------------------
------------------------------------------------------------
------------------------------------------------------------
------------------------------------------------------------
------------------------------------------------------------
------------------------------##################------------
------------------------------#                #------------
------------------------------#        -       #-- ---------
------------#-----------------#                #------------
------------#-----------------####GGGGGGGGGG####------------
------------#-----------------------------------------------
------------#-----------------------------------------------
------------#-------#---------------------------------------
------------#-------#---------------------------------------
------------#---*---############################------------
------------#-------#--------------------------#------------
------------#-------#--------------------------#------------
------------#-------############################------------
------------------------------------------------------------
-------------------------------------------M----------------
-------################################################-----
------------------------------------------------------------
------------------------------------------------------------
------------------------------------------------------------
------------------------------------------------------------
------------------------------------------------------------
------------------------------------------------------------
############################################################
OTHERSTUFF
