c
---------------------#----------#------
---------------------#----------#------
---------------------#----------#------
---------------------#----------#------
######################----------#------
---------------------#----------#------
---------------------#----------#------
---------------------#----------#------
---------------------#----------#------
#####>---------------#----------#------
----#>---------------#----------#------
----#>---------------#----------#------
----########---------#----------#------
----#>---------------#----------#------
----#>---------------#----------#------
----#>---------------#----------#------
----#>---------------#----------#------
---------------------#----------#------
---------------------#----------#------
#####----------------#----------#------
----#-------------C--#----------#------
----##################----------#------
---------------------#----------#------
---------------------#----------#------
---------------------#----------#------
---------------------#----------#------
---------------------#----------#------
---------------------#----------#------
---------------------#----------#------
---------------------#----------#------
