d
---------------------#----------#------
---------------------#----------#------
---------------------#----------#------
---------------------#----------#------
##########-----#######----------#######
,,,,,,,,,#-----#,,,,,,-----------------
---------#-----#-----------------------
---------#-----#-----------------------
---------#-----#-----------------------
---------#-----#-----------------------
---------#######-----------------------
---------,,,,,,,-----------------------
---------------------------------------
---------------------------------------
---------------------------------------
---------------------------------------
---------------------------------------
-----------------------------------####
-----------------------------------#---
-----------------------------------#---
-----------------------------------#---
-----------------------------------#---
-----------------------------------#---
-----------------------------------#---
######-------#######################---
-----#-------#-------------------------
-----#^^^^^^^#-------------------------
-----#########-------------------------
---------------------------------------
---------------------------------------
