d
---------------------#dddddddddd#-------
---------------------#----------#-------
---------------------#----------#-----##
##########-----#######----------#######,
#,,,,,,,,#-----#,,,,,,-----------------s
#--------#-----#-----------------------s
#--------#-----#-----------------------s
#--------#-----#-----------------------s
#--------#-----#-----------------------s
#--------#######-----------------------s
#---@----,,,,,,,-----@----------@------s
#--------------------------------------s
#--------------------------------------s
#--------------------------------------s
e--------------------------------------s
e--------------------------------------s
e----------------------------------####^
e----------------------------------#-###
e----------------------------------#----
e----------------------------------#----
e----------------------------------#----
e----------------------------------#----
e--------------------C-------------#----
######-------#######################----
-----#-------#--------------------------
-----#^^^^^^^#--------------------------
-----#########--------------------------
----------------------------------------
----------------------------------------
