d
---------------------#----------#-------
---------------------#----------#-------
---------------------#----------#-----##
##########-----#######----------#######,
#,,,,,,,,#-----#,,,,,,------------------
#--------#-----#------------------------
#--------#-----#------------------------
#--------#-----#------------------------
#--------#-----#------------------------
#--------#######------------------------
#---@----,,,,,,,-----@----------@-------
#---------------------------------------
#---------------------------------------
#---------------------------------------
e---------------------------------------
e---------------------------------------
e----------------------------------####^
e----------------------------------#-###
e----------------------------------#----
e----------------------------------#----
e----------------------------------#----
e----------------------------------#----
e--------------------G-----B-------#----
######-------#######################----
-----#-------#--------------------------
-----#^^^^^^^#--------------------------
-----#########--------------------------
----------------------------------------
----------------------------------------
