e
-------------------##-----------#------
-------------------##-----------#------
-------------------##-----------#------
-------------------########-----#------
###########################-----#------
--------------------------------#------
--------------------------------#------
--------------------------------#------
--------------------------------#------
----------------------------#####------
----------------------------#----------
------------------------#####----------
------------------------#--------------
--------------------#####--------------
--------------------###################
---------------------------------------
---------------------------------------
---------------------------------------
---------------------------------------
###-------#######----------------------
--#-------#-----#----------------------
--#-------#-----#----------------------
--#-------#-----#----------------------
--#-------#-----#----------------------
--#-------#-----#########-------#######
--#-------#-------------#########------
--#-------#----------------------------
--#-------#----------------------------
--#-------#----------------------------
--#-------#----------------------------
