f
#hhhhhhh#-------------------------------
#-------#-------------------------------
#-------#-------------------------------
#-------################################
#--------------------------------------e
#--------------------------------------e
#--------------------------------------e
#--------------------------------------e
#---------C----------------------------e
#####################------------------e
#####################---@--------@-----e
#,,,,,,,,,,,,,,----##------------------e
#--^^^^^^^^^^^^----##------------------e
#--############----##------------------e
#--#----------#----##------------------e
#--#----------#----##------------------e
#--#----------#------------------------e
####----------#--------I--------G------e
#--#------##############################
#--#------------------------------------
#--#------------------------------------
#--#------------------------------------
#--#------------------------------------
#--#------------------------------------
#--#------------------------------------
#--#------------------------------------
#--#------------------------------------
#--#------------------------------------
####------------------------------------
