f
#-------#------------------------------
#-------#------------------------------
#-------#------------------------------
#-------#------------------------------
#-------###############################
#--------------------------------------
#--------------------------------------
#--------------------------------------
#--------------------------------------
#--------------------------------------
#---------C----------------------------
####################-------------------
#,,,,,,,,,,,,,,----#-------------------
#--^^^^^^^^^^^^----#-------------------
#--############----#-------------------
#--#----------#----#-------------------
#--#----------#----#-------------------
#--#----------#------------------------
####----------#------------------------
#--#------#############################
#--#-----------------------------------
#--#-----------------------------------
#--#-----------------------------------
#--#-----------------------------------
#--#-----------------------------------
#--#-----------------------------------
#--#-----------------------------------
#--#-----------------------------------
#--#-----------------------------------
####-----------------------------------
