g
---------------------------------------
---------------------------------------
---------------------------------------
---------------------------------------
#######################################
---------------------------------------
---------------------------------------
---------------------------------------
---------------------------------------
###########--##########################
--------#------#----#------------------
--------#------#----#------------------
--------#^^^^^^#----#------------------
--------########----#------------------
--------------------#------------------
--------------------#------------------
-----################------------------
-----#>--------------------------------
-----#>--------------------------------
-----#>-----------------------#########
-----#>--------------------####--------
-----#>--------------------#-----------
-----#>----#################-----------
-----#>--------------------------------
-----#>--------------------------------
-----#>--------------------------------
-----#>--------------------------------
-----#>-------------------------^^^^^^^
-----################-----------#######
--------------------#-----------#------
