g
----------------------------------------
----------------------------------------
----------------------------------------
########################################
h--------------------------------------c
h--------------------------------------c
h--------------------------------------c
h--------------------------------------c
###########--###########################
--------#------#----#------------------c
--------#------#----#------------------c
--------#^^^^^^#----#------------------c
--------#TTTTTT#----#------------------c
--------#@ @@ @#----#------------------c
--------########----#------------------c
-----################------------------c
-----#>--------------------------------c
-----#>--------------------------------c
-----#>-----------------------##########
-----#>--------------------####--------#
-----#>--------------------#-----------#
-----#>---<#################-----------#
-----#>--------------------------------#
-----#>--------------------------------#
-----#>--------------------------------#
-----#>--------------------------------#
-----#>-------------------------^^^^^^^#
-----#########^^#####-----------########
------------#######-#eeeeeeeeeee#-------
