h
----------------------------------------
----------------------------------------
----------------------------------------
########################################
#----#--------######>-------------------
#----#---------#####>-------------------
#----#----------####>-------------------
#---##-----------###>-------------------
#####@-------------------###############
#------------------------#--------------
#------------------------#--------------
#------------------------#--------------
#------------------------#--------------
#------------------------#--------------
#------------------------#--------------
#------------------------#--------------
#------------------------#--------------
#-------^^^^^^^^^^^^^#####--------------
#-------##############------------------
#-------#-------------------------------
#-------#-------------------------------
#-------#-------------------------------
#-------#-------------------------------
#-------#-------------------------------
#-------#-------------------------------
#-------#-------------------------------
#-------#-------------------------------
#-------#-------------------------------
#-------#-------------------------------
