h
---------------------------------------
---------------------------------------
---------------------------------------
---------------------------------------
#######################################
#----#------------<#>------------------
#----#------------<#>------------------
#----#------------<#>------------------
#---##------------<#>------------------
#####--------------,-----##############
#------------------------#-------------
#------------------------#-------------
#------------------------#-------------
#------------------------#-------------
#------------------------#-------------
#------------------------#-------------
#------------------------#-------------
#------------------------#-------------
#-------^^^^^^^^^^^^^#####-------------
#-------##############-----------------
#-------#------------------------------
#-------#------------------------------
#-------#------------------------------
#-------#------------------------------
#-------#------------------------------
#-------#------------------------------
#-------#------------------------------
#-------#------------------------------
#-------#------------------------------
#-------#------------------------------
