i
--#eeeeeee#-----------------------------
--#-------#-----------------------------
--#-------#-----------------------------
--#-------#############-################
--#-------------------###--------------j
--#------------------------------------j
--#------------------------------------j
--#-------^----------------------------j
--#-------#######-----@-------------@--j
--#-------#-----#----------------------j
--#-------#-----#----------------------j
--#-------#-----#----------------------j
--#-------#-----#----------------------j
--#-------#-----#---------##############
--#-------#-----#---------#-------------
--#-------#-----#---------#-------------
--#-------#-----###########-------------
--#-------#-----------------------------
--####^^^^#-----------------------------
-----######-----------------------------
----------------------------------------
----------------------------------------
----------------------------------------
----------------------------------------
----------------------------------------
----------------------------------------
----------------------------------------
----------------------------------------
----------------------------------------
