i
--#eeeeeee#-----------------------------
--#-------#-----------------------------
--#-------#-----------------------------
--#-------#############-################
--#-------------------###---------------
--#-------------------------------------
--#-------------------------------------
--#-------^-----------------------------
--#-------#######-----@-------------@---
--#-------#-----#-----------------------
--#-------#-----#-----------------------
--#-------#-----#-----------------------
--#-------#-----#-----------------------
--#-------#-----#---------##############
--#-------#-----#---------#-------------
--#-------#-----#---------#-------------
--#-------#-----###########-------------
--#-------#-----------------------------
--####^^^^#-----------------------------
-----######-----------------------------
----------------------------------------
----------------------------------------
----------------------------------------
----------------------------------------
----------------------------------------
----------------------------------------
----------------------------------------
----------------------------------------
----------------------------------------
