j
----------------------------------------
----------------------------------------
----------------------------------------
########################################
i--------------------------------------q
i--------------------------------------q
i--------------------------------------q
i--------------------------------------q
i------------------@-------------@-----q
i--------------------------------------q
i--------------------------------------q
i--------------------------------------q
i--------------------------------------q
############---------------------------q
############---------------------------q
-----------#---------------------------q
-----------#---------------------------q
-----------#---------------------------q
-----------#---------------------@-----q
-----------#---------------------------q
-----------#---------------------------q
-----------#------C--------------------q
-----------#############---------------q
-----------------------#---------------q
-----------------------#---------------q
-----------------------#---------------q
-----------------------#---------------q
-----------------------#---------------q
-----------------------#nnnnnnnnnnnnnnn-
