r
-----------------------#oooooooo#-------
########################--------#-------
m---------##########------------#-------
m---------,,,,,,,,,,------------#-------
m----@---------------------@----#-------
m---------^^^^^^^^^^------------#-------
m---------##########------------#-------
####################TTTTTTTTTTTT####----
-----------------#-----------------#----
-----------------#-----------------#----
-----------------#-----------------#----
-----------------#-----------------#----
##################TTTTTTTTTTTTTTTTT#----
m----------------------------------#----
m----------------------------------#----
m----------------------------------#----
m--------------------------S-------#----
m-----------------##################----
m-----------------#---------------------
m-----------------#---------------------
m-----------------#---------------------
m--------C--------#---------------------
########################################
----------------------------------------
----------------------------------------
----------------------------------------
----------------------------------------
----------------------------------------
----------------------------------------
