l
-#>nnnnnnn<#----------------------------
-#>-------<#----------------------------
-#>-------<#----------------------------
-#>-------<#----------------------------
-#>-------<#----------------------------
-#>-------<#----------------------------
-#>---@---<#----------------------------
-#>-------<#----------------------------
-#>-------<#----------------------------
-#>-------<#############################
-#>------------------------------------m
-#>------------------------------------m
-#>------------------------------------m
-#>---@----------@----------@----------m
-#>------------------------------------m
-#>------------------------------------m
-#>------------------------------------m
-#>------------------------------------m
-#>---------------------------------C--m
-#########################-----#########
-------------------------#-----#--------
-------------------------#-----#--------
-------------------------#-----#--------
-------------------------#^^^^^#--------
-------------------------#######--------
----------------------------------------
----------------------------------------
----------------------------------------
----------------------------------------
