m
----------------------------------------
------------------######################
------------------#--------------------k
------------------#--------------------k
------------------#--------------------k
------------------#--------------------k
------------------#-----@--------------k
------------------#-----------##########
------------------#-----------#---------
###################-----------#---------
l-----------------------------#---------
l-----------------------------#---------
l-----------------------------##########
l------@---------@------------#--------k
l------------------------######--------k
l------------------------######--------k
l--------------------------------------k
l--------------------------------------k
l--------------------------------------k
######################-----------------k
---------------------#-----------------k
---------------------#-------------^^--k
---------------------###################
----------------------------------------
----------------------------------------
----------------------------------------
----------------------------------------
----------------------------------------
----------------------------------------
