o
-------#>ppppppp####################----
-------#>-------,,,,,,,,,,,,,,,,,,,#----
-------#>-------------------------<#----
-------#>---@---------------------<#----
-------#>-------------------------<#----
-------#>-------------------------<#----
-------#^^^^^^^^^^^^^^^^^^^-------<#----
-------####################>---@--<#----
-------####################>------<#----
-------#,,,,,,,,,,,,,,,,,,,-------<#----
-------#>-------------------------<#----
-------#>-------------------------<#----
-------#>-------------------------<#----
-------#>-------------------------<#----
-------#>-------------------------<#----
-------#>-------------------------<#----
-------#>-------^^^^^^^^^^^^^^^^^^^#----
-------#>---@--<######################--
-------#>------<#######################-
-------#>-------,,,,,,,,,,,,,,,,###-----
-------#>-----------------------#-------
-------#>-----------------------#-------
-------#>------------------@----#-------
-------#>-----------------------#-------
-------#>-----------------------#-------
-------#^^^^^^^^^^^^^^^^--------#-------
-------#################--------#-------
-----------------------#--------#-------
-----------------------#kkkkkkkk#-------
