p
----------------------------------------
----------------------------------------
----------------------------------------
-#######################################
-#-------------------------------------q
-#-------------------------------------q
-#-------------------------------------q
-#-------------------------------------q
-#-------------------------------------q
-#-------------------------------------q
-#---------------------------------#####
-#---------------------------------#----
##--------------------------------##----
##-----------------################-----
##-----------------#--------------------
-#---------#########--------------------
-#---------#-----------###########------
-#---------#-----------#---------##-----
-#---------#############----------#-----
-###------------------------------#-----
---#------------------------------#-----
---#------------------------------#-----
---#------------------------@-----#-----
---#------------------------------#-----
---#------------------------------#-----
---#------------------------------#-----
---#------------^^^^^^^^^^^^^^^^^^#-----
---#####--------###################-----
-------#oooooooo#-----------------------
