q
----------------------------------------
----------------------------------------
----------------------------------------
########################################
i--------<#--#>-------------------------
i--------<#--#>-------------------------
i--------<#--#>---@---------------------
i--------<#--#>-------------------------
i----@---<#--#>-------------------------
i--------<#--#>-------------------------
i--------<#--#>------###################
i--------<#--#>------#------------------
i--------<#--#>------#------------------
i--------<#--#>------###################
j--------<#--#>----------------------#--
j--------<#--#>----------------------#--
j--------<#--#>----------------------#--
j--------<#--#>---@-------------@----#--
j----@---<#--#>----------------------#--
j--------<#--#>----------------------#--
j--------<#--#>----------------------#--
j--------<#--###############---------###
j--------<#----------------#---------#-#
j--------<#----------------#---------#-#
j--------<##################---------###
j---------#----------------#---------#--
j---------#----------------#---------#--
j---------#----------------#---------#--
-rrrrrrrrr#----------------#rrrrrrrrr#rr
