r
-qqqqqqqqq#----------------#qqqqqqqqq#--
n---------#----------------#---------#--
n---------#----------------#---------#--
n---------##################---------###
n--------------------------------------#
n--------------------------------------#
n--------------------------------------#
n--------------------------------------#
n------@-------------------------@-----#
n--------------------------------------#
n--------------------------------------#
n--------------------------------------#
n----------------------C-------W-------#
n--------------#########################
n--------------#------------------------
n--------------#------------------------
n--------------#------------------------
n--------------#------------------------
n--------------#------------------------
n--------------#------------------------
n------@-------#------------------------
n--------------#------------------------
n--------------#------------------------
^^^^^^^^^^^^^^^#------------------------
################------------------------
--------------#-------------------------
----------------------------------------
----------------------------------------
----------------------------------------
