r
----------#----------------#---------#--
----------#----------------#---------#--
----------#----------------#---------#--
----------##################---------###
----------------------------------------
----------------------------------------
----------------------------------------
----------------------------------------
-------@-------------------------@------
----------------------------------------
----------------------------------------
----------------------------------------
-----------------------C-------W--------
---------------#########################
---------------#------------------------
---------------#------------------------
---------------#------------------------
---------------#------------------------
---------------#------------------------
---------------#------------------------
-------@-------#------------------------
---------------#------------------------
---------------#------------------------
^^^^^^^^^^^^^^^#------------------------
###############-------------------------
--------------#-------------------------
----------------------------------------
----------------------------------------
----------------------------------------
