s
-------------------------#zzzzzzzzzz#---
-------------------------#----------#---
##########################^^^^^^^^^^####
,,,,,,,,,,,,,,,,,,,,,,,,,,,,,,,,,,,,,,,#
d-------------------------------------<#
d-------------------------------------<#
d-------------------------------------<#
d-------------------------------------<#
d-------------------------------------<#
d-------------------------------------<#
d-------------------------------------<#
d-------------------------------------<#
d-------------------------------------<#
d-------------------------------------<#
d-------------------------------------<#
d-------------------------------------<#
^^^^^^^^^^^^^^^^^^^^^^^^^^^^^^^^^^^^^^^#
########################################
----------------------------------------
----------------------------------------
----------------------------------------
----------------------------------------
----------------------------------------
----------------------------------------
----------------------------------------
----------------------------------------
----------------------------------------
----------------------------------------
----------------------------------------
