second
------------------------------------------------------------
------------------------------------------------------------
------------------------------------------------------------
--------------------------------------------------------*---
------------------------------------------------------------
------------------------------------------------------------
------------------------------------------------------------
------------------------------------------------------------
------------------------------------------------------------
------------------------------------------------------------
------------------------------------------------------------
------------------------------------------------------------
------------------------------------------------------------
------------------------------------------------------------
------------------------------------------------------------
------------------------------------------------------------
------------------------------------------------------------
------------------------------------------------------------
-----------------S------------------------------------------
------------------------------------------------------------
------------------------------------------------------------
------------------------------------------------------------
------------------------------##################------------
------------v-----------------#                #------------
------------M-----------------#                #-- ---------
------------#-----------------#                #------------
------------#-----------------####GGGGGGGGGG####------------
------------#-----------------------------------------------
----^^^^^^^^#-------^---------------------------------------
----#########------<#>--------------------------------------
-----------*#-------#--------------V------------------------
------------#-------############################------------
T-----------#-------#--------------------------#------------
T-----------#-------#--------------------------#------------
T-----------#-------############################------------
T-----------------------------------------------------------
T-----------C---M----------M-------M-------M----------------
###################################################---------
------------------------------------------------------------
------------------------------------------------------------
----------------------I-------------------------------------
------------------------------------------------------------
------------------------------------------------------------
------------------------------------------------------------
tttttttttttttttttttttttttttttttttttttttttttttttttttttttttttt
OTHERSTUFF
