second
------------------------------------------------------------
------------------------------------------------------------
------------------------------------------------------------
--------------------------------------------------------*---
------------------------------------------------------------
------------------------------------------------------------
------------------------------------------------------------
------------------------------------------------------------
------------------------------------------------------------
------------------------------------------------------------
------------------------------------------------------------
------------------------------------------------------------
------------------------------------------------------------
------------------------------------------------------------
------------------------------------------------------------
------------------------------------------------------------
------------------------------------------------------------
------------------------------------------------------------
-----------------S------------------------------------------
------------------------------------------------------------
------------------------------------------------------------
------------------------------------------------------------
------------------------------##################------------
------------v-----------------#                #------------
------------M-----------------#                #-- ---------
------------#-----------------#                #------------
------------#-----------------####GGGGGGGGGG####------------
------------#-----------------------------------------------
----^^^^^^^^#-----------------------------------------------
----#########-------#---------------------------------------
-----------*#-------#--------------V------------------------
------------#-------############################------------
T-----------#-------#--------------------------#------------
T-----------#-------#--------------------------#------------
T-----------#-------############################------------
T-----------------------------------------------------------
T---------------M----------M-------M-------M----------------
#######################################################-----
------------------------------------------------------------
------------------------------------------------------------
----------------------I-------------------------------------
------------------------------------------------------------
------------------------------------------------------------
------------------------------------------------------------
############################################################
OTHERSTUFF
