start
------------------------------------------------------------
------------------------------------------------------------
------------------------------------------------------------
--------------------------------------------------------*---
------------------------------------------------------------
------------------------------------------------------------
------------------------------------------------------------
------------------------------------------------------------
------------------------------------------------------------
------------------------------------------------------------
------------------------------------------------------------
------------------------------------------------------------
------------------------------------------------------------
------------------------------------------------------------
------------------------------------------------------------
------------------------------------------------------------
------------------------------------------------------------
------------------------------------------------------------
-----------------S------------------------------------------
------------------------------------------------------------
------------------------------------------------------------
------------------------------------------------------------
------------------------------##################------------
------------v-----------------#                #------------
------------M-----------------#                #-- ---------
------------#-----------------#                #------------
------------#-----------------####GGGGGGGGGG####------------
------------#-----------------------------------------------
----^^^^^^^^#-----------------------------------------------
----#########-------#---------------------------------------
------------#-------#--------------V-----------------------t
------------#-------############################-----------t
------------#-------#--------------------------#-----------t
------------#-------#--------------------------#-----------t
------------#-------############################-----------t
---------------------#-------------------------------------t
----------j------M---------M-------M-------M-#-------------t
-------############################################-----####
------------------------------------------------------------
------------------------------------------------------------
----------------------I-------------------------------------
------------------------------------------------------------
------------------------------------------------------------
------------------------------------------------------------
############################################################
OTHERSTUFF
