z
a--------------------------------------a
a--------------------------------------a
a--------------------------------------a
a--*-----------------------------------a
a--------------------------------------a
a--------------------------------------a
a--------------------------------------a
a--------------------------------------a
a--------------------------------------a
a--------------------------------------a
a--------------------------------------a
a--------------------------------------a
a--------------------------------------a
a--------------------------------------a
a--------------------------------------a
a--------------------------------------a
a--------------------------------------a
a--------------------------------------a
a--------------------------------------a
a--------------------------------------a
a--------------------------------------a
###########################>-------<####
--------------------------#>-------<#---
--------------------------#>-------<#---
--------------------------#>-------<#---
--------------------------#>-------<#---
--------------------------#>-------<#---
--------------------------#>-------<#---
--------------------------#>sssssss<#---
